0000000000000000000000000000000000000000000000000000000000000000
0111111111111111111111111111111111111111111111111111111111111110
0111111111000000000000001111111111111111111111111111111111111110
0111111111011111111111101111111111111111111111111111111111111110
0111111111011111111111101111111111111111111111111111111111111110
0111111111011111111111101111111111111111111111111111111111111110
0111111111011111111111101111111111111111111111111111111111111110
0111111111011111111111101111111111111111111111111111111111111110
0111111111000000001111101111111111111111111111111111111111111110
0111111111011111111111111111111111111100000000000000111111111110
0111111111011111111111111111111111111111111111111111111111111110
0111111111011111111111111111111111111111111111111111111111111110
0111000000011111111111111111000000000000000000111111111111111110
0111111111111111111111111111111111111111111111111111111111111110
0111111111111111111111111111111111100000000000011111111111111110
0111111111111111111111111111111111111111111111111111111111111110
0111111111111111111111111111111111111111111111111111111111111110
0111111111111111111111111111111111111111111111111111111111111110
0111111111111111111111111111111111111111111111111111111111111110
0111111111111111111111111111111111111111111111111111111111111110
0111111111111111111111111111111111111111111111111111111111111110
0111111111111111111111111111111111111111111111111111111111111110
0111111111111111111111111111111111111111111111111111111111111110
0000000000000000000000000000000000000000000000000000000000000000